\  /==============================================================================================
|  |                                                                                             |
|  |   |-----|   |---|                                                                           |
|  |   |             |                                                                           |
|  |---|-------- ----|                                                                           |
|                                                                                                |
|-|-|-                                                                                           |
| | |                                                                                            |
|   |             |-----|                                                                        |
| | |             |     |                                                                        |
| | |             | |   |                                                                        |
| | |             | |   |                                                                        |
| | |             | |   |                                                                   |    |
| | |             | |   |---                                                                |    |
| | |             | |                                                                       |--| |
| | |             | |-------                                                                   | |
| | |             |     |                                                                 |----| |
| | |             |---| |                                                                 |      |
| | |             |     |          ----------                                             | |----|
| | |             | |---|                                                                        |
| | |             |     |                                                                 |----| |
| | |             |---| |                                                                 |      |
| | |             |     |                                                                 | |----|
| | | |-----------| |---|                                                                 |      |
| | |        |    |     |                                                                 |----| |
| | |------| |--| |---| |                                                           ------|      |
| |          |          |                                                           |     |   |--|
| |-|-------------------------------------------------------------------------------|-----|- ----|
|                                                                                                |
============================|/    \|==============================================================
